"aw" = (/obj/machinery/atmospherics/pipe/simple/supply/hidden{dir = 4},/obj/structure/closet/secure_closet/engineering_chief,/turf/open/floor/carpet/orange,/area/ship/crew)
"bc" = (/obj/machinery/computer/operating{dir = 1},/turf/open/floor/plasteel,/area/ship/engineering)
"bj" = (/obj/structure/cable/pink{icon_state = "1-8"},/turf/open/floor/plasteel,/area/ship/engineering)
"bN" = (/obj/machinery/atmospherics/pipe/simple/scrubbers/hidden{dir = 10},/obj/machinery/light{dir = 1},/obj/item/pipe_dispenser,/obj/structure/closet/crate,/obj/item/analyzer,/turf/open/floor/plasteel,/area/ship/engineering)
"cL" = (/turf/closed/wall/r_wall,/area/ship/bridge)
"eu" = (/obj/machinery/atmospherics/pipe/simple/scrubbers/hidden{dir = 8},/turf/open/floor/carpet/blue,/area/ship/crew)
"eQ" = (/obj/structure/window/reinforced/spawner/west,/obj/structure/window/reinforced/spawner/north,/obj/structure/window/reinforced/spawner/east,/obj/machinery/atmospherics/components/unary/outlet_injector/atmos/oxygen_input{dir = 1},/obj/machinery/air_sensor/atmos/oxygen_tank,/turf/open/floor/engine/o2,/area/ship/engineering)
"fr" = (/obj/machinery/power/smes/shuttle/precharged{dir = 4},/obj/structure/cable/cyan{icon_state = "0-8"},/obj/structure/window/reinforced/spawner/west,/obj/machinery/door/window/eastright,/turf/open/floor/plasteel,/area/ship/engineering)
"fF" = (/obj/machinery/light{dir = 1},/obj/structure/chair/sofa/left,/turf/open/floor/plasteel,/area/ship/engineering)
"fQ" = (/obj/machinery/vending/boozeomat/all_access,/turf/open/floor/plasteel,/area/ship/engineering)
"fW" = (/obj/machinery/atmospherics/components/binary/volume_pump{dir = 8},/turf/open/floor/plasteel,/area/ship/engineering)
"gf" = (/obj/structure/table/reinforced,/obj/item/radio/intercom/wideband,/turf/open/floor/plasteel,/area/ship/bridge)
"hd" = (/obj/structure/table/wood,/obj/item/flashlight/lamp/green{pixel_y = 14},/obj/item/valentine{pixel_x = 12; pixel_y = 10},/obj/item/stack/sheet/mineral/runite,/obj/item/toy/plush/hornet{pixel_x = -8; pixel_y = 11},/turf/open/floor/carpet/orange,/area/ship/crew)
"hm" = (/obj/machinery/atmospherics/pipe/simple/scrubbers/hidden{dir = 8},/turf/closed/wall,/area/ship/bridge)
"iy" = (/obj/machinery/atmospherics/pipe/simple/scrubbers/hidden{dir = 8},/obj/structure/table/bronze,/obj/item/storage/box/syringes{pixel_x = -6},/obj/item/storage/box/beakers{pixel_x = 6; pixel_y = 5},/turf/open/floor/plasteel,/area/ship/engineering)
"iA" = (/obj/machinery/computer/helm{dir = 8},/obj/structure/table/reinforced,/turf/open/floor/plasteel,/area/ship/bridge)
"iF" = (/obj/machinery/atmospherics/pipe/manifold/dark/hidden{dir = 8},/obj/machinery/meter,/turf/open/floor/plasteel,/area/ship/engineering)
"iI" = (/obj/structure/cable{icon_state = "0-2"},/obj/machinery/power/apc/auto_name/west,/obj/machinery/power/terminal{dir = 8},/turf/open/floor/plasteel,/area/ship/engineering)
"kB" = (/obj/machinery/light,/obj/structure/bed,/obj/item/bedsheet/cmo,/turf/open/floor/carpet/blue,/area/ship/crew)
"lh" = (/obj/machinery/atmospherics/pipe/simple/supply/hidden{dir = 4},/obj/machinery/atmospherics/pipe/simple/dark/hidden,/turf/open/floor/plasteel,/area/ship/engineering)
"li" = (/obj/machinery/atmospherics/components/trinary/filter/atmos/o2{dir = 4},/turf/open/floor/plasteel,/area/ship/engineering)
"lt" = (/obj/structure/cable{icon_state = "4-8"},/turf/open/floor/plasteel,/area/ship/engineering)
"lG" = (/turf/open/floor/carpet/blue,/area/ship/crew)
"lL" = (/obj/structure/cable{icon_state = "4-8"},/obj/machinery/door/airlock/wood,/turf/open/floor/plasteel,/area/ship/engineering)
"mP" = (/obj/machinery/atmospherics/components/unary/vent_scrubber,/obj/machinery/airalarm/all_access{pixel_y = 24},/turf/open/floor/engine/hull,/area/ship/external)
"mS" = (/obj/machinery/power/port_gen/pacman{anchored = 1},/obj/structure/cable/pink{icon_state = "0-4"},/obj/structure/cable{icon_state = "1-2"},/turf/open/floor/plasteel,/area/ship/engineering)
"ne" = (/obj/machinery/light,/obj/structure/table/optable,/obj/item/storage/backpack/duffelbag/med/surgery,/turf/open/floor/plasteel,/area/ship/engineering)
"ng" = (/obj/machinery/atmospherics/pipe/manifold/scrubbers/hidden{dir = 8},/obj/machinery/airalarm/all_access{pixel_y = 24},/obj/structure/rack,/obj/item/storage/bag/ore,/obj/item/mining_scanner,/obj/item/gps/mining,/obj/item/gps/mining,/obj/item/pickaxe,/turf/open/floor/plasteel,/area/ship/engineering)
"nn" = (/obj/structure/fans/tiny,/obj/machinery/atmospherics/pipe/simple/dark/hidden,/obj/machinery/door/airlock/external,/turf/open/floor/plasteel,/area/ship/engineering)
"nN" = (/obj/machinery/atmospherics/pipe/simple/scrubbers/hidden,/turf/closed/wall/r_wall,/area/ship/engineering)
"nS" = (/obj/machinery/atmospherics/components/unary/thermomachine/freezer,/turf/open/floor/plasteel,/area/ship/engineering{dir = 8})
"od" = (/obj/structure/cable{icon_state = "4-8"},/obj/machinery/atmospherics/components/trinary/mixer/airmix/flipped{dir = 8},/turf/open/floor/plasteel,/area/ship/engineering)
"pM" = (/turf/closed/wall,/area/ship/bridge)
"pO" = (/obj/machinery/atmospherics/components/trinary/filter/atmos/n2{dir = 4},/turf/open/floor/plasteel,/area/ship/engineering)
"pS" = (/turf/open/floor/plasteel,/area/ship/crew)
"qk" = (/obj/structure/window/reinforced/spawner/west,/obj/structure/window/reinforced/spawner,/obj/structure/window/reinforced/spawner/east,/obj/machinery/atmospherics/components/unary/vent_pump/siphon/atmos/nitrogen_output,/turf/open/floor/engine/n2,/area/ship/engineering)
"qm" = (/obj/structure/cable{icon_state = "4-8"},/obj/machinery/atmospherics/components/unary/vent_pump/on{dir = 1},/obj/structure/cable{icon_state = "1-8"},/turf/open/floor/plasteel,/area/ship/crew)
"qs" = (/obj/structure/cable{icon_state = "1-4"},/obj/machinery/vending/cigarette,/turf/open/floor/plasteel,/area/ship/engineering)
"qK" = (/obj/structure/dresser,/turf/open/floor/carpet/blue,/area/ship/crew)
"qO" = (/obj/machinery/door/airlock/command{name = "Bridge"},/obj/structure/cable{icon_state = "4-8"},/turf/open/floor/plasteel,/area/ship/bridge)
"rx" = (/obj/structure/cable{icon_state = "4-8"},/turf/open/floor/plasteel,/area/ship/crew)
"rW" = (/obj/machinery/door/airlock/command{name = "Bridge"},/turf/open/floor/plasteel,/area/ship/bridge)
"se" = (/obj/machinery/door/airlock/public,/obj/machinery/atmospherics/pipe/simple/scrubbers/hidden,/turf/open/floor/plasteel,/area/ship/engineering)
"ss" = (/obj/machinery/power/shuttle/engine/electric{dir = 4},/obj/structure/cable/cyan{icon_state = "0-4"},/turf/open/floor/plasteel,/area/ship/engineering)
"sB" = (/obj/machinery/light/small{dir = 4},/obj/machinery/vending/games,/turf/open/floor/plasteel,/area/ship/engineering)
"sM" = (/obj/structure/table/bronze,/obj/item/flashlight/lamp/green{pixel_x = -3; pixel_y = 14},/obj/item/slime_cookie/pink{pixel_x = 8; pixel_y = 3},/obj/item/toy/plush/plushvar{pixel_x = -8; pixel_y = -4},/turf/open/floor/carpet/blue,/area/ship/crew)
"sR" = (/obj/machinery/power/terminal{dir = 8},/obj/structure/cable{icon_state = "0-2"},/obj/structure/cable,/turf/open/floor/plasteel,/area/ship/engineering)
"sX" = (/obj/machinery/power/shuttle/engine/fueled/expulsion{dir = 4},/turf/open/floor/plasteel,/area/ship/engineering)
"tc" = (/obj/machinery/atmospherics/components/unary/vent_scrubber{dir = 1},/turf/open/floor/engine/hull,/area/ship/external)
"tQ" = (/obj/docking_port/mobile{dir = 2; launch_status = 0; port_direction = 8},/turf/closed/wall/r_wall,/area/ship/engineering)
"ur" = (/obj/structure/window/reinforced/spawner/west,/obj/structure/window/reinforced/spawner,/obj/structure/window/reinforced/spawner/east,/obj/machinery/atmospherics/components/unary/vent_pump/siphon/atmos/mix_output,/turf/open/floor/engine/vacuum,/area/ship/engineering)
"uU" = (/obj/machinery/atmospherics/pipe/simple/scrubbers/hidden,/obj/structure/table/bronze,/obj/machinery/chem_dispenser/drinks/beer{dir = 8; pixel_y = 0},/turf/open/floor/plasteel,/area/ship/engineering)
"vq" = (/obj/machinery/atmospherics/components/unary/shuttle/heater{dir = 4},/obj/structure/window/reinforced/spawner/west,/obj/machinery/door/window/eastright,/turf/open/floor/plasteel,/area/ship/engineering)
"vB" = (/obj/structure/window/reinforced/spawner/west,/obj/structure/window/reinforced/spawner/north,/obj/structure/window/reinforced/spawner/east,/obj/machinery/atmospherics/components/unary/outlet_injector/atmos/mix_input{dir = 1},/obj/machinery/air_sensor/atmos/mix_tank,/turf/open/floor/engine/vacuum,/area/ship/engineering)
"vI" = (/obj/machinery/atmospherics/pipe/simple/dark/hidden{dir = 4},/turf/open/floor/plasteel,/area/ship/engineering)
"vU" = (/obj/machinery/atmospherics/components/unary/vent_scrubber/on/layer3,/turf/open/floor/plasteel,/area/ship/bridge)
"vV" = (/obj/structure/chair/bronze{dir = 4},/turf/open/floor/plasteel,/area/ship/bridge)
"wc" = (/obj/machinery/atmospherics/pipe/simple/scrubbers/hidden{dir = 8},/turf/closed/wall,/area/ship/engineering)
"wB" = (/turf/closed/wall/r_wall,/area/ship/engineering)
"xf" = (/obj/machinery/modular_computer/console/preset/command{dir = 8},/obj/structure/table/reinforced,/turf/open/floor/plasteel,/area/ship/bridge)
"xN" = (/obj/machinery/atmospherics/pipe/simple/scrubbers/hidden,/obj/machinery/atmospherics/pipe/simple/supply/hidden{dir = 4},/obj/structure/table/bronze,/obj/item/reagent_containers/glass/rag,/turf/open/floor/plasteel,/area/ship/engineering)
"yb" = (/obj/machinery/atmospherics/pipe/simple/scrubbers/hidden{dir = 8},/obj/machinery/atmospherics/pipe/simple/dark/hidden,/turf/open/floor/plasteel,/area/ship/engineering)
"yq" = (/obj/machinery/atmospherics/components/unary/vent_scrubber/on/layer3{dir = 4},/obj/structure/chair/office/light,/turf/open/floor/plasteel,/area/ship/engineering)
"yv" = (/obj/machinery/chem_heater,/obj/structure/table/bronze,/turf/open/floor/plasteel,/area/ship/engineering)
"yB" = (/obj/structure/cable{icon_state = "4-8"},/obj/machinery/atmospherics/pipe/simple/cyan/hidden/layer2{dir = 9},/turf/open/floor/plasteel,/area/ship/engineering)
"zj" = (/obj/item/soap,/obj/item/stack/sheet/mineral/runite,/turf/open/floor/plasteel,/area/ship/engineering)
"zk" = (/turf/closed/wall,/area/ship/engineering)
"zq" = (/obj/structure/window/reinforced/spawner/west,/obj/structure/window/reinforced/spawner,/obj/structure/window/reinforced/spawner/east,/obj/machinery/atmospherics/components/unary/vent_pump/high_volume/siphon/atmos/air_output,/obj/machinery/atmospherics/pipe/simple/cyan/hidden/layer2,/turf/open/floor/engine/air,/area/ship/engineering)
"zv" = (/obj/machinery/cryopod{dir = 1},/obj/machinery/computer/cryopod{pixel_y = 24},/turf/open/floor/plasteel,/area/ship/engineering)
"zy" = (/obj/machinery/computer/atmos_control/tank/air_tank,/obj/machinery/atmospherics/pipe/manifold/supply/hidden,/obj/machinery/atmospherics/pipe/simple/cyan/hidden/layer2,/turf/open/floor/plasteel,/area/ship/engineering)
"zQ" = (/obj/machinery/computer/atmos_control/tank/nitrogen_tank,/obj/machinery/atmospherics/pipe/simple/supply/hidden{dir = 4},/obj/machinery/atmospherics/pipe/simple/general/hidden,/turf/open/floor/plasteel,/area/ship/engineering)
"AW" = (/obj/machinery/door/airlock/public,/turf/open/floor/plasteel,/area/ship/engineering)
"Ba" = (/obj/machinery/atmospherics/pipe/simple/scrubbers/hidden,/turf/open/floor/plasteel,/area/ship/engineering)
"Bk" = (/obj/structure/window/reinforced/spawner/west,/obj/structure/window/reinforced/spawner/north,/obj/structure/window/reinforced/spawner/east,/obj/machinery/atmospherics/components/unary/outlet_injector/atmos/nitrogen_input{dir = 1},/obj/machinery/air_sensor/atmos/nitrogen_tank,/turf/open/floor/engine/n2,/area/ship/engineering)
"Bn" = (/obj/machinery/atmospherics/pipe/manifold4w/scrubbers/hidden,/turf/open/floor/plasteel,/area/ship/engineering)
"BK" = (/obj/structure/table/reinforced,/obj/machinery/power/apc/auto_name/north,/obj/machinery/power/terminal{dir = 1},/obj/structure/cable{icon_state = "0-2"},/obj/item/areaeditor/shuttle{pixel_y = 12},/obj/machinery/button/door{id = "windshield_shutters"; name = "Windshield Shutters"; pixel_y = -2},/turf/open/floor/plasteel,/area/ship/bridge)
"Dn" = (/obj/machinery/atmospherics/pipe/simple/dark/hidden,/turf/open/floor/engine/hull,/area/ship/external)
"Du" = (/obj/machinery/atmospherics/pipe/simple/dark/hidden,/turf/open/floor/plasteel,/area/ship/engineering)
"DQ" = (/obj/machinery/atmospherics/pipe/simple/supply/hidden{dir = 4},/turf/closed/wall,/area/ship/bridge)
"DT" = (/obj/structure/cable{icon_state = "2-8"},/obj/machinery/atmospherics/components/unary/vent_pump/on{dir = 4},/turf/open/floor/plasteel,/area/ship/engineering)
"EO" = (/obj/machinery/holopad/emergency/engineering,/obj/machinery/airalarm/all_access{dir = 4; pixel_x = -24},/obj/machinery/atmospherics/pipe/simple/supply/hidden{dir = 10},/obj/machinery/light{dir = 1},/turf/open/floor/plasteel,/area/ship/bridge)
"EQ" = (/obj/structure/window/reinforced/spawner/west,/obj/structure/window/reinforced/spawner,/obj/structure/window/reinforced/spawner/east,/obj/machinery/atmospherics/components/unary/vent_pump/siphon/atmos/oxygen_output,/turf/open/floor/engine/o2,/area/ship/engineering)
"FH" = (/obj/machinery/light/small,/turf/open/floor/plasteel,/area/ship/engineering)
"FY" = (/obj/structure/cable{icon_state = "4-8"},/obj/machinery/atmospherics/pipe/simple/general/hidden{dir = 5},/turf/open/floor/plasteel,/area/ship/engineering)
"Ge" = (/obj/structure/cable{icon_state = "4-8"},/obj/machinery/atmospherics/components/unary/vent_pump/on{dir = 1},/turf/open/floor/plasteel,/area/ship/bridge)
"Ha" = (/obj/structure/chair/comfy/shuttle{dir = 4},/obj/structure/cable{icon_state = "1-8"},/turf/open/floor/plasteel,/area/ship/bridge)
"HH" = (/obj/structure/table/reinforced,/obj/machinery/computer/crew{dir = 8},/turf/open/floor/plasteel,/area/ship/bridge)
"Ic" = (/obj/machinery/atmospherics/pipe/simple/scrubbers/hidden{dir = 8},/obj/structure/closet/secure_closet/CMO,/turf/open/floor/carpet/blue,/area/ship/crew)
"Id" = (/obj/machinery/holopad/emergency/medical,/obj/machinery/firealarm{dir = 4; pixel_x = -24},/obj/machinery/atmospherics/pipe/simple/scrubbers/hidden{dir = 9},/obj/machinery/light,/turf/open/floor/plasteel,/area/ship/bridge)
"IW" = (/obj/machinery/atmospherics/pipe/simple/scrubbers/hidden,/turf/closed/wall,/area/ship/engineering)
"IY" = (/obj/machinery/autolathe,/turf/open/floor/plasteel,/area/ship/engineering)
"Jy" = (/obj/item/mop,/obj/item/reagent_containers/glass/bucket,/obj/machinery/atmospherics/pipe/simple/dark/hidden{dir = 4},/turf/open/floor/plasteel,/area/ship/engineering)
"Kg" = (/obj/structure/chair/sofa/right,/turf/open/floor/plasteel,/area/ship/engineering)
"KS" = (/obj/machinery/atmospherics/pipe/manifold/supply/hidden{dir = 1},/obj/machinery/power/terminal{dir = 8},/obj/machinery/power/apc/auto_name/west,/obj/structure/cable{icon_state = "0-2"},/obj/machinery/suit_storage_unit/ce,/turf/open/floor/carpet/orange,/area/ship/crew)
"Lm" = (/obj/machinery/power/smes/engineering,/obj/structure/cable,/obj/structure/cable{icon_state = "0-2"},/turf/open/floor/plasteel,/area/ship/engineering)
"LR" = (/obj/machinery/light/small{dir = 4},/obj/structure/reagent_dispensers/fueltank,/turf/open/floor/plasteel,/area/ship/engineering)
"MF" = (/obj/structure/mirror{pixel_y = 28},/obj/structure/sink{pixel_y = 17},/obj/machinery/light/small,/turf/open/floor/plasteel,/area/ship/engineering)
"MM" = (/obj/structure/dresser,/turf/open/floor/carpet/orange,/area/ship/crew)
"NX" = (/obj/machinery/power/terminal{dir = 8},/obj/structure/cable/pink{icon_state = "0-2"},/turf/open/floor/plasteel,/area/ship/engineering)
"Po" = (/obj/machinery/atmospherics/pipe/simple/supply/hidden{dir = 4},/turf/closed/wall,/area/ship/engineering)
"PP" = (/obj/machinery/atmospherics/pipe/simple/scrubbers/hidden{dir = 8},/turf/open/floor/plasteel,/area/ship/engineering)
"Qa" = (/obj/machinery/chem_master,/obj/structure/table/bronze,/obj/machinery/atmospherics/pipe/simple/scrubbers/hidden,/turf/open/floor/plasteel,/area/ship/engineering)
"QE" = (/obj/machinery/atmospherics/pipe/simple/dark/hidden{dir = 9},/turf/open/floor/plasteel,/area/ship/engineering)
"Rr" = (/obj/machinery/light,/obj/machinery/chem_dispenser,/obj/structure/table/bronze,/turf/open/floor/plasteel,/area/ship/engineering)
"Rt" = (/obj/structure/cable{icon_state = "4-8"},/obj/machinery/atmospherics/pipe/simple/dark/hidden,/turf/open/floor/plasteel,/area/ship/engineering)
"RA" = (/obj/machinery/atmospherics/pipe/layer_manifold,/obj/structure/tank_dispenser,/turf/open/floor/plasteel,/area/ship/engineering)
"RT" = (/obj/machinery/door/airlock/hatch{name = "external access hatch"},/obj/machinery/atmospherics/pipe/simple/dark/hidden,/turf/open/floor/plasteel,/area/ship/engineering)
"Se" = (/obj/machinery/computer/atmos_control/tank/oxygen_tank,/obj/machinery/atmospherics/pipe/simple/supply/hidden{dir = 4},/obj/machinery/atmospherics/pipe/simple/general/hidden,/turf/open/floor/plasteel,/area/ship/engineering)
"Tc" = (/obj/machinery/power/terminal{dir = 8},/obj/structure/cable,/turf/open/floor/plasteel,/area/ship/engineering)
"Th" = (/obj/machinery/atmospherics/components/unary/vent_scrubber/on/layer3,/turf/open/floor/plasteel,/area/ship/crew)
"UD" = (/obj/structure/cable{icon_state = "4-8"},/obj/machinery/atmospherics/pipe/layer_manifold{dir = 4},/obj/machinery/atmospherics/pipe/simple/dark/hidden,/turf/open/floor/plasteel,/area/ship/engineering)
"Vj" = (/obj/structure/table/bronze,/turf/open/floor/plasteel,/area/ship/engineering)
"Vx" = (/obj/structure/table/reinforced,/obj/machinery/computer/monitor{dir = 8},/turf/open/floor/plasteel,/area/ship/bridge)
"VD" = (/obj/machinery/door/airlock/wood,/turf/open/floor/plasteel,/area/ship/engineering)
"VK" = (/turf/open/space/basic,/area/space)
"VN" = (/obj/machinery/light{dir = 1},/obj/structure/bed,/obj/item/bedsheet/ce,/turf/open/floor/carpet/orange,/area/ship/crew)
"Wm" = (/obj/structure/window/reinforced/spawner/west,/obj/structure/window/reinforced/spawner/north,/obj/structure/window/reinforced/spawner/east,/obj/machinery/atmospherics/components/unary/outlet_injector/atmos/air_input{dir = 1},/obj/machinery/air_sensor/atmos/air_tank,/obj/machinery/atmospherics/pipe/simple/cyan/hidden/layer2,/turf/open/floor/engine/air,/area/ship/engineering)
"Wy" = (/turf/open/floor/plasteel,/area/ship/engineering)
"WD" = (/obj/machinery/atmospherics/pipe/simple/supply/hidden{dir = 4},/turf/open/floor/carpet/orange,/area/ship/crew)
"WI" = (/obj/effect/spawner/structure/window/reinforced,/obj/machinery/door/poddoor/shutters/preopen{id = "windshield_shutters"; name = "windshield shutters"},/turf/open/floor/plasteel,/area/ship/bridge)
"Xb" = (/obj/machinery/computer/atmos_control/tank/mix_tank,/obj/machinery/atmospherics/pipe/simple/supply/hidden{dir = 4},/obj/machinery/atmospherics/pipe/simple/dark/hidden,/turf/open/floor/plasteel,/area/ship/engineering)
"Xz" = (/obj/machinery/atmospherics/pipe/simple/dark/hidden{dir = 10},/turf/open/floor/plasteel,/area/ship/engineering)
"XD" = (/obj/structure/cable{icon_state = "4-8"},/obj/machinery/atmospherics/pipe/simple/scrubbers/hidden,/obj/structure/table/bronze,/obj/machinery/chem_dispenser/drinks{dir = 8; pixel_y = 0},/turf/open/floor/plasteel,/area/ship/engineering)
"XS" = (/obj/machinery/power/terminal{dir = 8},/obj/structure/cable,/obj/structure/cable{icon_state = "0-2"},/obj/structure/cable{icon_state = "0-4"},/turf/open/floor/plasteel,/area/ship/engineering)
"Yb" = (/turf/closed/wall/r_wall,/area/ship/crew)
"YG" = (/obj/machinery/atmospherics/pipe/manifold/dark/hidden{dir = 8},/turf/open/floor/plasteel,/area/ship/engineering)
"YL" = (/obj/machinery/power/terminal{dir = 8},/obj/structure/cable{icon_state = "0-2"},/obj/structure/cable,/obj/item/stack/sheet/mineral/plasma/five,/turf/open/floor/plasteel,/area/ship/engineering)
"Za" = (/turf/open/floor/carpet/orange,/area/ship/crew)
"Zl" = (/obj/machinery/atmospherics/pipe/manifold/scrubbers/hidden,/obj/machinery/airalarm/all_access{dir = 4; pixel_x = -24},/obj/machinery/suit_storage_unit/cmo,/turf/open/floor/carpet/blue,/area/ship/crew)

(1,1,1) = {"
VKVKVKwBwBwBtQwBwBVKVKVKVKVKVKVKVKVKVKVK
VKVKsXvqfWvIXzsBwBwBVKVKVKVKVKVKVKVKVKVK
VKVKVKwBwBwBRTwBwBVKVKVKVKVKVKVKVKVKVKVK
VKVKVKVKVKmPDnVKVKVKVKVKVKVKVKVKVKVKVKVK
VKVKwBwBwBnNnnwBwBwBwBwBVKVKVKVKVKVKVKVK
VKwBwBKgfFngybpOlibNRAwBYbYbYbVKVKVKVKVK
VKwBiIWyWyBaDuBkeQvBWmzkhdVNYbcLcLVKVKVK
ssfrsRWyfQuUDuqkEQurzqzkZaZaMMpMcLcLWIWI
ssfrXSltDTxNlhzQSeXbzyPoKSWDawDQEOBKVxWI
VKwBLmNXqsXDRtFYodUDyBlLqmrxrxqOGeHaiAWI
VKwBmSbjWyBaiFvIvIQEWyVDThpSpSrWvUvVxfWI
ssfrYLWyyqBnybPPPPPPiywcZleuIchmIdgfHHWI
ssfrTcyvRrQaDuIYbcneVjzklGlGqKpMcLcLWIWI
VKwBzkzkzkIWYGnSzkzkzkzksMkBYbcLcLVKVKVK
VKwBwBzjMFseDuWyAWFHzvwBYbYbYbVKVKVKVKVK
VKVKwBwBwBnNnnwBwBwBwBwBVKVKVKVKVKVKVKVK
VKVKVKVKVKtcDnVKVKVKVKVKVKVKVKVKVKVKVKVK
VKVKVKwBwBwBRTwBwBVKVKVKVKVKVKVKVKVKVKVK
VKVKsXvqfWJyQELRwBwBVKVKVKVKVKVKVKVKVKVK
VKVKVKwBwBwBwBwBwBVKVKVKVKVKVKVKVKVKVKVK
"}
